1111111111
10001000E1
1000100111
1000000111
1P10C00001
1111111111