1111111111
10C01C00E1
10P00C0111
100010C111
1110C00001
1111111111