111111
1PX0E1
100001
111111 


DA RICORDARSI IL DOPPIO FREE