111111
1PX0E1
100C01
111111 


