11111111111111111111
10C00F00000000F000E1
100010000C00000000F1
10000110000F000C0001
1000000000000C000001
10000000F000000C0001
10000100000C00000001
10000000000000000001
100000C0000F00000001
10000000000000000001
1P0000F0000000000001
11111111111111111111