1111111
1P00CE1
10000E1
1111111