1111111111
1P00111101
1111000C01
1000011101
1011111111
1010000001
1010111111
1010000EC1
1111111111