1111111111
1P00011101
1111000C01
1000011101
1011110001
101A000C01
1010111101
101C0000E1
1111111111