1111111
1P00CE1
1P00001
1111111